1
##########
#@$....O.#
##########
2
##########
#@$....O.#
#........#
##########
3
##########
#@.......#
#....$...#
#.......O#
##########
4
##########
#@.......#
#........#
#..$....O#
##########
5
##########
#@.......#
#....$...#
#....O...#
#........#
##########
e